wwwwwwww
wc--b-xw
w--b--ww
w--xw-ww
ww-ww-ww
ww-b-xww
wwwwwwww
wwwwwwww
