wwwwwwww
w---b-xw
wc-b--ww
w--xw-ww
ww-ww-ww
ww-b-xww
ww---bxw
wwwwwwww
